                         
                         
                         
       #####             
       #   #             
      ##B  #             
     ##   B##            
     #  B B #            
    ### # # #  ######    
   ##   # # ####  SS#    
   #  B  B        SS#    
   ###### ####P#  SS#    
        ###  ########    
                         
                         
                         
                         