                         
                         
        #####            
        #   #####        
        # #B##  #        
        #     B #        
######### ###   #        
#SSSS  ## B  B###        
#SSSS    B BB ##         
#SSSS  ##B  B P#         
#########  B  ##         
        # B B  #         
        ### ## #         
          #    #         
          ######         
                         
                         