                         
                         
                         
            ########     
            #     P#     
            # B#B ##     
            # B  B#      
            ##B B #      
     ######## B # ###    
     #SSSS ## B  B  #    
     ##SSS   B  B   #    
     #SSSS ##########    
     #######             
                         
                         
                         
                         