                         
                         
                         
      ######  ###        
      #SS  # ##P##       
      #SS  ###   #       
      #SS     BB #       
      #SS  # # B #       
      #SS### # B #       
      #### B #B  #       
         #  B# B #       
         # B  B  #       
         #  ##   #       
         #########       
                         
                         
                         