#########################
#########################
#########################
#########################
########000##############
########B00##############
#######000B##############
######00B0B0#############
#######0#0#0#############
#####000#0#0#####0SS#####
####00B00B00000000SS#####
#########0####P##0SS#####
#########################
#########################
#########################